111111111
1E0000001
101P01011
101001001
101000001
111111111
