111111111111111111111111111111
1E0000000000000000000000000001
101001010000000C00CC0000000001
101001001000000000CC0000000001
1P0000000C00000C00000000000001
1P0000000C00000C00000000000001
1P0000000C00000C00000000000001
1P0000000C00000C00000000000001
111111111111111111111111111111