11111111111111111111111
1E000000000000000000001
101001010000000C00CC001
101001001000000000CC001
1P0000000C00000C0000001
1P0000000C00000C0000001
1P0001100C00000C0000001
1P0000000C00000C0000001
11111111111111111111111