1111111111111111111111
1E00000000000000000001
101001010000000C00CC01
101001001000000000CC01
1P0000000C00000C000001
1111111111111111111111